                       
   AEED            AD  
  AIOOH      AEED  FH  
  FOOOLED    FOOLEEILD 
  FOOOOOLEEEEIOOOOOOOH 
  BJOOOOOOOOOOOOOOOOOH 
   FOOOOOOOOOOOOOOOOOH 
   FOOOOOOOOOOOOOOOOOH 
 AEIOOOOOOOOOOOOOOOOKC 
 FOOOOOOOOOOOOOOOOOOH  
 BGJOOOOKGGGJOOOOOOOH  
   FOKGGC   FOOOKGGGC  
   BGC      BGGGC      
                      
