                      
   AEEED     AEED     
  AIOOOLEED  FOOLEED  
  FOOOOOOOLEEIOOOOOLD 
 AIOOOOOOOOOOOOKGGGJH 
 FOOOOOOOOOOOOKC   FH 
 FOOOOOOOOOOOOH   AIH 
 FOOOOOOOOOOOOH  AIKC 
 FOOOOOOOOOOOKC  FOH  
 BJOOOOOOOOOOH   FOH  
  BGGJOOOOOKGC   BJLD 
     BGGJOOH      BGC 
        BGGC          
                      