                        
         AEEEEEEED      
        AIOOOOOOOH      
     AEEIOOOOOOOOLEEED  
  AEEIOOOOOOOOOOOOOOOH  
 AIOOOOOOOOOOOOOOOOOOLD 
 FOOOOOOOOOOOOOOOOOOOOH 
 FOOOOOOOOOOOOOOOOOOOOH 
 FOOOOOOOOOOOOOOOOOOOOH 
 FOOOOOOOKGGJOOOOOOOOKC 
 BJOOOOOKC  BJOOOOOOOH  
  FOOOOKC    BJOOOOOOH  
  BGGGGC      BGGGGGGC  
                        