                        
         AEEEEEEEED     
   AEEEEEIOOOOOOOOLEEED 
 AEIOOOOOOOOOOOOOOOOOOH 
 FOOOOOOOOOOOOOOOOOOOOH 
 FOOOOOOOOOOOOOOOOOOOKC 
 FOOOOOOOOOOOOOOOOOOOH  
 BJOOOOOOOOOOOOOOOOOOH  
  FOOOOOOOOOOOOOOOOOOH  
  FOOOOOOOOOOOOOOOOOOH  
  BGJOOOOOOOKGGGGGJOKC  
    BGJOOOOKC     BGC   
      BGGGGC            
                        