                        
 AEEEEED   AEEED    AED 
 BGJOOOLEEEIOOOLD   FOH 
   FOOOOOOOOOOOOLEEEIKC 
   FOOOOOOOOOOOOOOOOOH  
   FOOOOOOOOOOOOOOOOOH  
  AIOOOOOOOOOOOOOOOOOLD 
  FOOOOOOOOOOOOOOOOOOOH 
  FOOOOOOOOOOOOOOOOOOOH 
 AILGGJOOOOOOOOOOOOOOOH 
 FOH  BJOOOOOOOOOOOOOKC 
 BGC   BGGGGJOOOOOKGGC  
            BGGGGGC     
                        