                         
  AEEEEED               
 AEIOOOOLEED            
 FOOOOOOOOOLED   AED    
 BJOOOOOOOOOOLEEEIOLD   
  FOOOOOOOOOOOOOOOOOLED 
  FOOOOOOOOOOOOOOOOOOOH 
  FOOOOOOOOOOOOOOOOOOOH 
 AIOOOOOOOOOOOOOOOOOOKC 
 FOOOOOOOOOOOOOOOOOOOH  
 FOOOOOOOOOOOOOOOOOOOH  
 BGGGGJOKGGJOOOOOKGGGC  
      BGC  BGGGGGC      