                      
          AEEEEEED    
     AEEEEIOOOOOOLEED 
 AEEEIOOOOOOOOOOOOOOH 
 FOOOOOOOOOOOOOOOOOOH 
 BJOOOOOOOOOOOOOOOOKC 
  FOOOOOOOOOOOOOOOOH  
  FOOOOOOOOOOOOOOOOH  
  BJOOOOOOOOOOOOOOOH  
   FOOOOOOOOOOOOOOOH  
   FKGGGGJOOOOOOOOOLD 
   BC    BGGGJOOOOOOH 
             BGGGGGGC 
                      