                        
      AEEEEEED  AD      
      FOOOOOOKEEILD     
     AIOOOOOOOOOOOLD    
    AIOOOOOOOOOOOOOLD   
   AIOOOOOOOOOOOOOOOLD  
  AIOOOOOOOOOOOOOOOOOH  
 AIOOOOOOOOOOOOOOOOOOLD 
 FOOOOOOOOOOOOOOOOOOOOH 
 BGJOOOOOOOOOOOKGGJOOOH 
   FOOOOOOOOOOKC  FOOKC 
   BJOOOOOOKGGC   FOKC  
    BGGGGGGC      BGC   
                        